Barcode	CellType
AAAGATGGTGGTTTCA.1	TBLC
AAAGTAGAGACTACAA.1	TBLC
AACTCAGAGTACACCT.1	TBLC
AAGGTTCAGTGCAAGC.1	TBLC
AATCCAGCAATAAGCA.1	TBLC
ACACCAACAAGGTTTC.1	TBLC
ACACCCTTCACATGCA.1	TBLC
ACACCGGTCAGCATGT.1	TBLC
ACAGCCGCAGCATACT.1	TBLC
ACAGCTATCTTATCTG.1	TBLC
ACATCAGTCTGTTGAG.1	TBLC
ACGATACGTCCGTGAC.1	TBLC
ACGCCAGCACCACCAG.1	TBLC
ACGCCAGTCCGGCACA.1	TBLC
ACGGAGATCATCATTC.1	TBLC
ACGGGTCCAGCGAACA.1	TBLC
ACGTCAATCGTATCAG.1	TBLC
ACTGAACAGTGAATTG.1	TBLC
ACTGAGTAGAAGGCCT.1	TBLC
ACTGATGTCAATAAGG.1	TBLC
ACTTACTGTAATTGGA.1	TBLC
ACTTGTTTCGTCCAGG.1	TBLC
AGAGCGAAGTCAAGGC.1	TBLC
AGCCTAAGTCCTCCAT.1	TBLC
AGCGTATCAGTGGAGT.1	TBLC
AGGGAGTAGGCCCTTG.1	TBLC
AGGGAGTCACCCAGTG.1	TBLC
AGGGATGCAACCGCCA.1	TBLC
AGGTCATGTCGCATCG.1	TBLC
AGGTCCGTCTGAGGGA.1	TBLC
AGTGTCAAGGTGCTTT.1	TBLC
ATAGACCAGATGGCGT.1	TBLC
ATCATGGGTGTGGTTT.1	TBLC
ATCGAGTCACAGGCCT.1	TBLC
ATCTACTTCCACGCAG.1	TBLC
ATCTGCCGTGTGAAAT.1	TBLC
ATGGGAGGTAAGGGCT.1	TBLC
ATGGGAGGTGACTCAT.1	TBLC
ATTTCTGCAGACACTT.1	TBLC
ATTTCTGGTTTGTTTC.1	TBLC
CAACCAACAAACGCGA.1	TBLC
CAAGATCCACGGTTTA.1	TBLC
CAAGATCTCATAACCG.1	TBLC
CACACTCAGAGTTGGC.1	TBLC
CACAGGCCACGGCCAT.1	TBLC
CACAGTACACACGCTG.1	TBLC
CACATAGCAGTCAGAG.1	TBLC
CACCTTGGTAGGGTAC.1	TBLC
CAGCCGAAGTCGAGTG.1	TBLC
CAGCCGAGTTAAGGGC.1	TBLC
CAGCTGGTCGGAATCT.1	TBLC
CAGGTGCAGCTTTGGT.1	TBLC
CAGGTGCAGGGCACTA.1	TBLC
CAGGTGCGTTGGACCC.1	TBLC
CAGGTGCGTTGTCTTT.1	TBLC
CATATGGAGAGTAATC.1	TBLC
CATCAAGTCCTGCTTG.1	TBLC
CATCCACGTTGTGGAG.1	TBLC
CATCGGGTCTCAACTT.1	TBLC
CATGGCGAGAGGGCTT.1	TBLC
CATGGCGTCGAGAACG.1	TBLC
CATTCGCAGGGTTCCC.1	TBLC
CATTCGCTCACCGGGT.1	TBLC
CATTCGCTCGATAGAA.1	TBLC
CCACTACAGCAGCGTA.1	TBLC
CCCAATCAGAGACTAT.1	TBLC
CCCAATCTCCCTCAGT.1	TBLC
CCCAGTTGTTCCACTC.1	TBLC
CCCTCCTCAGTGAGTG.1	TBLC
CCCTCCTGTGCCTTGG.1	TBLC
CCGGTAGGTTCCACAA.1	TBLC
CCTAGCTGTTTAGGAA.1	TBLC
CCTAGCTTCGAGAGCA.1	TBLC
CCTATTACATCGGGTC.1	TBLC
CCTTACGAGCAGATCG.1	TBLC
CCTTACGCAACAACCT.1	TBLC
CCTTACGCAGTTCCCT.1	TBLC
CGAATGTCATGCCCGA.1	TBLC
CGAATGTGTCTGCGGT.1	TBLC
CGACTTCCACAGCCCA.1	TBLC
CGACTTCCACCGATAT.1	TBLC
CGAGAAGAGTGAATTG.1	TBLC
CGAGCACGTCCGAATT.1	TBLC
CGAGCCACATGCCACG.1	TBLC
CGATCGGCATCCAACA.1	TBLC
CGATGGCAGCGAAGGG.1	TBLC
CGATGTATCACTTATC.1	TBLC
CGCCAAGTCATGTGGT.1	TBLC
CGCTGGAGTAGCTGCC.1	TBLC
CGCTTCATCCACGTTC.1	TBLC
CGGACTGAGGCTCTTA.1	TBLC
CGGACTGTCGCAGGCT.1	TBLC
CGGAGCTAGGCCCTTG.1	TBLC
CGGAGCTCAGATGGGT.1	TBLC
CGTAGCGTCCATGCTC.1	TBLC
CGTTCTGCAATCTACG.1	TBLC
CGTTCTGCACTGAAGG.1	TBLC
CGTTGGGAGCCAGTAG.1	TBLC
CTAACTTCATTGGCGC.1	TBLC
CTAATGGGTAGGAGTC.1	TBLC
CTACATTGTCCTCTTG.1	TBLC
CTACCCAAGACATAAC.1	TBLC
CTACCCACAAACGTGG.1	TBLC
CTAGAGTCATCTCGCT.1	TBLC
CTAGTGAAGTACGACG.1	TBLC
CTCAGAAAGTGTCCAT.1	TBLC
CTCCTAGTCCGTCAAA.1	TBLC
CTCGGGATCTCGTTTA.1	TBLC
CTCGTACAGTGAACAT.1	TBLC
CTGATCCCACAACTGT.1	TBLC
CTGATCCGTCTGCAAT.1	TBLC
CTGCTGTGTCCATGAT.1	TBLC
CTGCTGTTCACGACTA.1	TBLC
CTGGTCTTCAGCACAT.1	TBLC
CTGTGCTGTCAAACTC.1	TBLC
CTTACCGCACTGCCAG.1	TBLC
CTTACCGGTTTGGGCC.1	TBLC
CTTCTCTAGACCGGAT.1	TBLC
CTTGGCTCAAACCCAT.1	TBLC
GAAGCAGGTAGCGTCC.1	TBLC
GAATAAGTCGCAAACT.1	TBLC
GACACGCGTCTTGATG.1	TBLC
GACAGAGCAAGCTGAG.1	TBLC
GACCTGGAGATCGGGT.1	TBLC
GACGCGTAGTGGAGAA.1	TBLC
GACGCGTCATTCACTT.1	TBLC
GACGCGTGTCCAAGTT.1	TBLC
GACGTTAGTTACTGAC.1	TBLC
GACTGCGGTCCTCCAT.1	TBLC
GAGTCCGCATGCTAGT.1	TBLC
GATCGTAAGTAGGCCA.1	TBLC
GATCGTAGTGTCGCTG.1	TBLC
GATCTAGGTTAGGGTG.1	TBLC
GATGAAAGTCTAGAGG.1	TBLC
GCAAACTAGAAACCGC.1	TBLC
GCAAACTGTTGATTCG.1	TBLC
GCACTCTCATCAGTCA.1	TBLC
GCATACAGTCTAGTGT.1	TBLC
GCATGCGAGAAGGGTA.1	TBLC
GCGAGAATCAACGGCC.1	TBLC
GCGCAACCAAATTGCC.1	TBLC
GCGCAACGTATGAATG.1	TBLC
GCGCAGTGTCAGTGGA.1	TBLC
GCGCAGTGTGTGCCTG.1	TBLC
GCGCGATCAAACTGCT.1	TBLC
GCTCCTAAGGAGTTTA.1	TBLC
GCTCTGTCACTATCTT.1	TBLC
GCTGCTTCAATCTGCA.1	TBLC
GCTGCTTCATGTTGAC.1	TBLC
GGAACTTAGAAGGTGA.1	TBLC
GGACAAGCACATCCGG.1	TBLC
GGACAGAAGGCAGTCA.1	TBLC
GGACATTAGCGTAGTG.1	TBLC
GGATGTTTCCTTTCGG.1	TBLC
GGCAATTGTCAACATC.1	TBLC
GGCCGATGTCGGCTCA.1	TBLC
GGGACCTCACCGAATT.1	TBLC
GGGATGAAGAGCTATA.1	TBLC
GGGCACTGTTGATTCG.1	TBLC
GGGCACTTCGTACCGG.1	TBLC
GGGCATCCAGCAGTTT.1	TBLC
GGGTTGCAGACCACGA.1	TBLC
GGGTTGCCATTTGCTT.1	TBLC
GGTATTGAGAAACGCC.1	TBLC
GGTGCGTGTCAGAGGT.1	TBLC
GGTGTTAGTTCGCTAA.1	TBLC
GGTGTTATCAGCATGT.1	TBLC
GTAACGTAGCGTCTAT.1	TBLC
GTAACGTGTCATTAGC.1	TBLC
GTACTTTCAAGACACG.1	TBLC
GTATCTTGTCAAGCGA.1	TBLC
GTCAAGTAGGAGTACC.1	TBLC
GTCAAGTCACGGTGTC.1	TBLC
GTCACAATCCTCAACC.1	TBLC
GTCACGGCACCCTATC.1	TBLC
GTCACGGTCACTTACT.1	TBLC
GTCATTTTCGTGGGAA.1	TBLC
GTCGGGTGTGGTACAG.1	TBLC
GTCGGGTTCCGCATAA.1	TBLC
GTCTCGTCAAGTAGTA.1	TBLC
GTCTTCGGTGGTTTCA.1	TBLC
GTGCAGCCATTGCGGC.1	TBLC
GTGCAGCGTCCGTTAA.1	TBLC
TAAACCGTCGCGGATC.1	TBLC
TAAACCGTCTCGATGA.1	TBLC
TACAGTGTCGCGGATC.1	TBLC
TACGGGCGTCCAGTTA.1	TBLC
TACGGGCGTGACGCCT.1	TBLC
TACTCATTCTGCCAGG.1	TBLC
TAGACCATCGCGCCAA.1	TBLC
TAGAGCTCACCTGGTG.1	TBLC
TAGAGCTTCAGGCGAA.1	TBLC
TAGCCGGTCAAACGGG.1	TBLC
TAGTTGGAGCGCCTTG.1	TBLC
TCACGAAGTAAGTAGT.1	TBLC
TCAGCAACACGTAAGG.1	TBLC
TCAGCAATCATAAAGG.1	TBLC
TCAGCTCTCCATGAGT.1	TBLC
TCAGGATGTCTGCAAT.1	TBLC
TCAGGATTCATGGTCA.1	TBLC
TCCCGATAGATATGGT.1	TBLC
TCGCGAGGTGAACCTT.1	TBLC
TCGCGAGTCGGCTTGG.1	TBLC
TCGCGTTTCTAACCGA.1	TBLC
TCGGGACAGGGCTCTC.1	TBLC
TCGTAGATCTTACCGC.1	TBLC
TCTCTAAAGAGCCTAG.1	TBLC
TCTGAGAGTACCATCA.1	TBLC
TCTGAGAGTCGCGGTT.1	TBLC
TCTGAGAGTTAGAACA.1	TBLC
TCTTTCCGTTGTTTGG.1	TBLC
TGACTTTCAACTGGCC.1	TBLC
TGAGGGAAGGCTAGAC.1	TBLC
TGAGGGATCCAGTAGT.1	TBLC
TGCCAAAGTTATGTGC.1	TBLC
TGCCCATTCACCTTAT.1	TBLC
TGCGCAGAGACGCTTT.1	TBLC
TGCGCAGTCTGTCTCG.1	TBLC
TGCTGCTTCTGTTTGT.1	TBLC
TGGGCGTTCCAACCAA.1	TBLC
TGTATTCCACGGTAAG.1	TBLC
TGTGGTAAGACTAAGT.1	TBLC
TGTGGTATCAGCTCGG.1	TBLC
TGTTCCGAGCTGCGAA.1	TBLC
TTCGAAGGTCTAACGT.1	TBLC
TTCTACAAGCTAAACA.1	TBLC
TTCTTAGAGGGCACTA.1	TBLC
TTGACTTGTTAAAGAC.1	TBLC
TTGCCGTCACACCGCA.1	TBLC
TTGCCGTCATCGGACC.1	TBLC
TTGCCGTGTGACTCAT.1	TBLC
TTGCGTCCAGGAATGC.1	TBLC
TTGGAACTCACTATTC.1	TBLC
TTGTAGGGTCGTGGCT.1	TBLC
TTGTAGGTCAAGCCTA.1	TBLC
TTTGCGCGTAGAGCTG.1	TBLC
TTTGGTTCAAGGACTG.1	TBLC
AAACGGGCAAGTTGTC.1	PSC
AAAGATGTCGCATGGC.1	PSC
AACCGCGGTGTGTGCC.1	PSC
AACTCTTGTATCAGTC.1	PSC
ACAGCTAAGCTGAAAT.1	PSC
ACAGCTACAGGACCCT.1	PSC
ACAGCTATCAGTGCAT.1	PSC
ACATCAGGTGGCGAAT.1	PSC
ACATGGTCACTGAAGG.1	PSC
ACCAGTAAGTACATGA.1	PSC
ACCCACTGTTGGTGGA.1	PSC
ACCTTTAGTGGGTATG.1	PSC
ACCTTTATCTCCTATA.1	PSC
ACCTTTATCTGCCAGG.1	PSC
ACGGGCTAGACCACGA.1	PSC
ACGGGCTTCCAAGCCG.1	PSC
ACGTCAAAGCGATCCC.1	PSC
ACGTCAAGTCTCAACA.1	PSC
ACTATCTAGTGTCTCA.1	PSC
ACTGAGTCAATAACGA.1	PSC
ACTGCTCAGTCAAGGC.1	PSC
ACTGTCCGTACAGACG.1	PSC
ACTTACTTCCACGTGG.1	PSC
ACTTGTTCAAACGCGA.1	PSC
AGAATAGAGTGGGCTA.1	PSC
AGACGTTAGGAATCGC.1	PSC
AGACGTTCAATGTTGC.1	PSC
AGAGCGATCTCGGACG.1	PSC
AGAGTGGGTATTACCG.1	PSC
AGAGTGGTCCCGACTT.1	PSC
AGATCTGAGTGTACTC.1	PSC
AGCAGCCCACCAGATT.1	PSC
AGCAGCCTCGGCCGAT.1	PSC
AGCATACGTCCAACTA.1	PSC
AGCCTAAAGAAGGTGA.1	PSC
AGGCCGTCAATAGCAA.1	PSC
AGGGAGTGTGCGATAG.1	PSC
AGGGTGAGTTAAAGTG.1	PSC
AGGTCATTCAACCAAC.1	PSC
AGTAGTCAGGCAGGTT.1	PSC
AGTCTTTGTCCAGTGC.1	PSC
AGTCTTTTCGAACGGA.1	PSC
AGTGGGACATGAACCT.1	PSC
AGTGTCAGTGCAGTAG.1	PSC
AGTTGGTAGAGAGCTC.1	PSC
AGTTGGTTCTGTCAAG.1	PSC
ATCACGAAGAATGTTG.1	PSC
ATCATGGAGTATCTCG.1	PSC
ATCTACTAGTCGAGTG.1	PSC
ATGAGGGTCGGATGTT.1	PSC
ATGGGAGAGATGCCAG.1	PSC
ATTACTCCAGCGTAAG.1	PSC
ATTACTCTCACTTATC.1	PSC
ATTCTACCACGTTGGC.1	PSC
CAACTAGAGCTAAACA.1	PSC
CAACTAGAGGGTGTTG.1	PSC
CAAGATCTCTGAGGGA.1	PSC
CAAGTTGTCATCGATG.1	PSC
CACCTTGCATGCGCAC.1	PSC
CACTCCAAGAACTCGG.1	PSC
CAGAATCTCGGCCGAT.1	PSC
CAGAGAGCACCTGGTG.1	PSC
CAGCAGCAGGCTCTTA.1	PSC
CAGCCGAGTGAGGGAG.1	PSC
CAGCGACGTCTCGTTC.1	PSC
CAGGTGCCAACCGCCA.1	PSC
CAGTCCTGTGCGATAG.1	PSC
CATATTCCAAATTGCC.1	PSC
CATCAAGAGTGACATA.1	PSC
CATCAAGTCATTGCCC.1	PSC
CATCAGAAGATCTGAA.1	PSC
CATCAGATCAACGGCC.1	PSC
CATCAGATCGGGAGTA.1	PSC
CATCAGATCTGCCAGG.1	PSC
CATCGGGCATCATCCC.1	PSC
CATGCCTGTCGAGATG.1	PSC
CATGCCTTCGTTTATC.1	PSC
CATGGCGAGACGCAAC.1	PSC
CATGGCGTCTTAACCT.1	PSC
CCAATCCGTACCGGCT.1	PSC
CCACCTACATGCAATC.1	PSC
CCACGGAGTACAGTTC.1	PSC
CCCAATCGTTGAGTTC.1	PSC
CCGGGATGTGTGTGCC.1	PSC
CCGTTCATCCACTCCA.1	PSC
CCTAGCTTCGCCTGAG.1	PSC
CCTCTGAAGCTTCGCG.1	PSC
CCTTCCCGTAATAGCA.1	PSC
CCTTCGACACGGTGTC.1	PSC
CCTTTCTCATGTCGAT.1	PSC
CGAACATCAGATCTGT.1	PSC
CGAATGTAGGGCACTA.1	PSC
CGAGCCACAGGTCTCG.1	PSC
CGATCGGCATCGACGC.1	PSC
CGATTGATCAGAGGTG.1	PSC
CGCGGTAGTCTGGTCG.1	PSC
CGCTATCCAGTGACAG.1	PSC
CGGAGCTAGTAGCCGA.1	PSC
CGGAGCTTCAGCATGT.1	PSC
CGGAGTCTCACAATGC.1	PSC
CGGGTCAAGTCATGCT.1	PSC
CGGGTCACAAAGGTGC.1	PSC
CGGGTCACATAGACTC.1	PSC
CGTAGCGGTAGCCTCG.1	PSC
CGTAGGCCAGACGCCT.1	PSC
CGTCACTAGACAAAGG.1	PSC
CGTCACTAGTGTTTGC.1	PSC
CGTCACTGTTAGATGA.1	PSC
CTAACTTTCTGAAAGA.1	PSC
CTAAGACGTACCGCTG.1	PSC
CTAAGACGTTAAGGGC.1	PSC
CTAAGACTCCAGATCA.1	PSC
CTAATGGAGTACGCCC.1	PSC
CTACACCGTTGATTCG.1	PSC
CTACCCACAATCAGAA.1	PSC
CTACGTCAGCCAGAAC.1	PSC
CTAGAGTTCTAACTCT.1	PSC
CTCACACGTTCTCATT.1	PSC
CTCACACTCCGTCATC.1	PSC
CTCATTATCGGATGGA.1	PSC
CTCGGAGCAGCATACT.1	PSC
CTCGTACAGTGGAGAA.1	PSC
CTCGTACGTCCGTGAC.1	PSC
CTCTAATGTCGCGGTT.1	PSC
CTCTACGGTAGCGTAG.1	PSC
CTGAAGTAGTGGGATC.1	PSC
CTGCCTAGTGACAAAT.1	PSC
CTGCTGTCAATGGATA.1	PSC
CTGCTGTCACGGCCAT.1	PSC
CTGTGCTTCCCAGGTG.1	PSC
CTGTTTACACATCCAA.1	PSC
CTTACCGTCCTCTAGC.1	PSC
CTTAGGATCGGGAGTA.1	PSC
CTTTGCGCAAGAAGAG.1	PSC
GAAACTCCAATGAAAC.1	PSC
GAAGCAGGTTGAACTC.1	PSC
GAAGCAGGTTGAGGTG.1	PSC
GACCAATAGATCTGCT.1	PSC
GACGTGCAGCGAGAAA.1	PSC
GACGTTAGTATGAATG.1	PSC
GACTAACCATATGGTC.1	PSC
GAGCAGAGTATCGCAT.1	PSC
GAGTCCGCAGGGCATA.1	PSC
GATCAGTTCGGAGGTA.1	PSC
GATCGATTCGTGGTCG.1	PSC
GATGAAAAGCTACCGC.1	PSC
GATGAAACAGGGTACA.1	PSC
GATGAGGAGTCGAGTG.1	PSC
GCAATCACAGCCTTGG.1	PSC
GCATACATCAGCTCTC.1	PSC
GCATGATAGGATGGAA.1	PSC
GCATGTAAGCCGCCTA.1	PSC
GCATGTATCCTCAATT.1	PSC
GCCAAATCAAGTCTAC.1	PSC
GCCTCTAAGATTACCC.1	PSC
GCCTCTATCTCAAGTG.1	PSC
GCGACCATCAACACAC.1	PSC
GCGCAACAGGTGCTAG.1	PSC
GCGCAACGTCGTCTTC.1	PSC
GCGCGATCACCCTATC.1	PSC
GCGGGTTGTGGTAACG.1	PSC
GCTCCTAAGCAGCCTC.1	PSC
GCTGCAGGTCCAGTGC.1	PSC
GCTGCAGTCATGTAGC.1	PSC
GCTGCTTAGACTTGAA.1	PSC
GCTGCTTCAAGAGGCT.1	PSC
GCTTGAATCCACGTGG.1	PSC
GGAAAGCCATCCAACA.1	PSC
GGAATAAGTGAGGGAG.1	PSC
GGACATTGTATAAACG.1	PSC
GGACGTCTCCACGAAT.1	PSC
GGACGTCTCCCAAGAT.1	PSC
GGATTACAGTGTTAGA.1	PSC
GGATTACTCGTATCAG.1	PSC
GGCAATTTCAACGCTA.1	PSC
GGCCGATTCCGCGTTT.1	PSC
GGGAATGCAAAGGCGT.1	PSC
GGGCACTCACAAGACG.1	PSC
GGGCATCGTGTCTGAT.1	PSC
GGGTCTGCATTGCGGC.1	PSC
GGGTTGCTCCAAGTAC.1	PSC
GGTGAAGCAATCCGAT.1	PSC
GGTGTTAGTAGATTAG.1	PSC
GGTGTTATCACGATGT.1	PSC
GTACTTTAGACCGGAT.1	PSC
GTACTTTGTGATAAAC.1	PSC
GTCGGGTGTACCTACA.1	PSC
GTCTTCGAGTATTGGA.1	PSC
GTGCGGTGTGCACTTA.1	PSC
GTGCTTCGTCGGCTCA.1	PSC
GTGTGCGCACCGCTAG.1	PSC
GTGTTAGAGTACACCT.1	PSC
GTTAAGCTCAGTTCGA.1	PSC
GTTACAGCACTACAGT.1	PSC
GTTCATTTCGGTGTTA.1	PSC
GTTTCTACAGAGTGTG.1	PSC
TAAGAGAAGTGCTGCC.1	PSC
TAAGAGATCGGCTTGG.1	PSC
TAAGCGTGTCGAACAG.1	PSC
TACAGTGAGTGCCATT.1	PSC
TACCTTAGTTCACCTC.1	PSC
TACGGATTCGGCGGTT.1	PSC
TACGGGCTCTGGAGCC.1	PSC
TACTCATCAGTCGTGC.1	PSC
TAGACCAGTCGCATCG.1	PSC
TAGAGCTAGTCTTGCA.1	PSC
TAGAGCTCAGCTGGCT.1	PSC
TAGAGCTCATGTCCTC.1	PSC
TAGTGGTCAGACGTAG.1	PSC
TAGTGGTTCTAACTTC.1	PSC
TATCAGGGTGATGTGG.1	PSC
TATGCCCAGATCACGG.1	PSC
TATGCCCGTACCAGTT.1	PSC
TATTACCCACATGGGA.1	PSC
TATTACCTCCTAAGTG.1	PSC
TCAATCTTCAACACAC.1	PSC
TCACAAGAGTTCCACA.1	PSC
TCACAAGCAACGATGG.1	PSC
TCAGCTCAGAAGGCCT.1	PSC
TCAGCTCCAACTGCTA.1	PSC
TCAGGTATCTGCTGTC.1	PSC
TCCACACCACCTATCC.1	PSC
TCCACACTCAGTTGAC.1	PSC
TCGCGAGGTGGCCCTA.1	PSC
TCGGGACGTCTCTCTG.1	PSC
TCGGTAAAGACGCAAC.1	PSC
TCGTAGATCGACGGAA.1	PSC
TCTATTGTCAGCTCGG.1	PSC
TCTCTAAAGATGTCGG.1	PSC
TCTGAGACACGGCCAT.1	PSC
TCTGGAACAGACGCCT.1	PSC
TGACTAGGTCTTGCGG.1	PSC
TGACTTTTCCTTCAAT.1	PSC
TGAGAGGAGGTAGCCA.1	PSC
TGAGAGGGTGTCCTCT.1	PSC
TGAGAGGGTTCCACTC.1	PSC
TGAGCATCACCACGTG.1	PSC
TGAGCATCAGTCTTCC.1	PSC
TGAGCCGGTAGGGACT.1	PSC
TGCACCTCAGCTGTAT.1	PSC
TGCGCAGAGAATTCCC.1	PSC
TGCGCAGAGATCTGCT.1	PSC
TGGCCAGTCCGTTGCT.1	PSC
TGGCTGGGTGACGCCT.1	PSC
TGGGAAGAGAGACTTA.1	PSC
TGGTTCCGTTGCGTTA.1	PSC
TGTGTTTCAAACTGCT.1	PSC
TGTGTTTGTGTGGTTT.1	PSC
TGTTCCGAGGGTGTTG.1	PSC
TTAACTCGTGTAACGG.1	PSC
TTATGCTAGCTGCAAG.1	PSC
TTCCCAGTCTTGCCGT.1	PSC
TTCGAAGCAGTGACAG.1	PSC
TTCGGTCGTATAATGG.1	PSC
TTCTACACAATAGAGT.1	PSC
TTCTCCTCAACTGCTA.1	PSC
TTGAACGAGAGTGACC.1	PSC
TTGAACGAGGCATTGG.1	PSC
TTGAACGCAGCGTTCG.1	PSC
TTGAACGCAGCTGTTA.1	PSC
TTGACTTCAGTATAAG.1	PSC
TTGGAACCACGGTTTA.1	PSC
TTTGTCACACAGTCGC.1	PSC
